-1 -1 -1 -1 -1 8 -1 -1 -1 3 
20 19 19 19 19 3 14 20 19 3 
-1 -1 -1 -1 -1 3 14 14 14 14 
-1 -1 -1 -1 -1 3 14 14 14 14 
-1 -1 -1 -1 -1 12 14 14 14 14 
-1 -1 -1 1 0 0 13 14 14 14 
-1 -1 -1 -1 -1 -1 12 13 -1 3 
-1 -1 -1 -1 -1 -1 -1 6 -1 16 
-1 -1 -1 -1 -1 -1 -1 -1 -1 17 
-1 -1 -1 -1 1 0 0 0 19 0 

